1
8 8
4 4
1 1 1 1 1 1 1 1
1 1 1 3 1 1 1 1
1 1 1 0 1 1 1 1
1 1 1 0 0 0 3 1
1 3 0 0 0 1 1 1
1 1 1 1 0 1 1 1
1 1 1 1 3 5 1 1
1 1 1 1 1 1 1 1


