0
6 8
2 2
1 1 1 1 1 1
1 1 0 0 3 1
1 0 0 1 1 1
1 1 0 0 1 1
1 1 0 0 0 1
1 3 1 0 0 1
1 0 3 5 3 1
1 1 1 1 1 1